[['1' '1' '2' '2' '0' '0' '4' '4' '4' '4']
 ['1' '2' '2' '0' '0' '0' '0' '4' '4' '4']
 ['1' '2' '2' '0' '0' '0' '0' '4' '4' '4']
 ['1' '2' '2' '2' '0' '0' '0' '4' '4' '4']
 ['1' '2' '2' '2' '2' '0' '4' '4' '4' '4']
 ['1' '1' '2' '2' '2' '3' '3' '3' '4' '4']
 ['1' '1' '2' '2' '3' '3' '3' '3' '3' '4']
 ['1' '1' '1' '3' '3' '3' '3' '3' '3' '3']
 ['1' '1' '1' '1' '3' '3' '3' '3' '3' '3']
 ['1' '1' '1' '1' '3' '3' '3' '3' '3' '3']]
